15 15
0 7
+ - - - - - + 0 + - - - - - + 
| 0 0 0 0 0 0 0 0 0 0 0 0 0 | 
| 0 + - - - + 0 + - + 0 + - + 
| 0 | 0 0 0 | 0 0 0 | 0 0 0 | 
| 0 | 0 + 0 + - + 0 + - + 0 | 
| 0 | 0 | 0 | 0 | 0 | 0 | 0 | 
+ - + 0 | 0 | 0 + 0 + 0 | 0 | 
| 0 | 0 | 0 | 0 0 0 0 0 | 0 | 
| 0 + 0 | 0 | 0 + - + - + 0 | 
| 0 0 0 | 0 | 0 0 0 | 0 0 0 | 
+ - + - + 0 | 0 + - + 0 + 0 | 
| 0 | 0 0 0 | 0 | 0 0 0 | 0 | 
| 0 + 0 + - + - + 0 + - + 0 | 
| 0 0 0 0 0 0 0 0 0 | 0 0 0 | 
+ - - - - - + 0 + - + - - - + 
