63 63
0 31
+ - + - - - - - - - + - - - - - - - + - - - - - + - - - - - + 0 + - - - + - - - - - - - + - - - - - - - - - - - - - + - - - + 
| 0 | 0 0 0 0 0 0 0 | 0 0 0 0 0 0 0 | 0 0 0 0 0 | 0 0 0 0 0 0 0 | 0 0 0 | 0 0 0 0 0 0 0 | 0 0 0 0 0 0 0 0 0 0 0 0 0 | 0 0 0 | 
| 0 | 0 + - - - + 0 + 0 + - + 0 + 0 | 0 + - + 0 | 0 + - + 0 + 0 + 0 + 0 + 0 + - - - + 0 + - + 0 + - - - - - + 0 + 0 + 0 + 0 | 
| 0 | 0 0 0 0 0 | 0 0 0 | 0 | 0 | 0 | 0 0 0 | 0 | 0 | 0 | 0 | 0 0 0 | 0 0 0 | 0 0 0 | 0 0 0 | 0 0 0 0 0 0 0 | 0 | 0 0 0 | 0 | 
| 0 + - - - + 0 + - - - + 0 | 0 | 0 | 0 + - + 0 | 0 | 0 | 0 + - + - + - + - + 0 + - + - + 0 + - + - - - + 0 | 0 + - - - + 0 | 
| 0 0 0 0 0 | 0 0 0 0 0 0 0 | 0 | 0 | 0 | 0 0 0 | 0 | 0 | 0 0 0 | 0 0 0 | 0 | 0 0 0 0 0 | 0 0 0 | 0 0 0 0 0 | 0 | 0 0 0 | 0 | 
| 0 + - - - + - + - - - + 0 | 0 + - + 0 | 0 + - + 0 | 0 + - + 0 + 0 + 0 | 0 | 0 + - + 0 + - + 0 | 0 + - + - + 0 | 0 + - + 0 | 
| 0 | 0 0 0 0 0 | 0 0 0 | 0 | 0 0 0 | 0 | 0 | 0 0 0 | 0 0 0 | 0 0 0 | 0 | 0 | 0 0 0 | 0 0 0 0 0 | 0 0 0 | 0 0 0 | 0 0 0 0 0 | 
| 0 + 0 + - + 0 + 0 + 0 | 0 + - + 0 + 0 | 0 | 0 + - + 0 + - + - + - + 0 | 0 + - + 0 + - + - - - + - + 0 | 0 + - + - + 0 + - + 
| 0 0 0 | 0 | 0 0 0 | 0 | 0 | 0 | 0 0 0 | 0 | 0 0 0 0 0 | 0 0 0 | 0 0 0 | 0 0 0 | 0 0 0 | 0 0 0 0 0 0 0 | 0 0 0 0 0 | 0 0 0 | 
| 0 + - + 0 + - + - + 0 | 0 | 0 + - + - + 0 + - + 0 + - + 0 + 0 + 0 + - + - + 0 + - + 0 + - - - + 0 + - + - + - + 0 + - + 0 | 
| 0 | 0 0 0 0 0 | 0 0 0 | 0 | 0 0 0 | 0 0 0 0 0 | 0 | 0 0 0 | 0 0 0 | 0 0 0 0 0 | 0 0 0 | 0 0 0 | 0 0 0 0 0 | 0 0 0 | 0 0 0 | 
| 0 + - - - + 0 | 0 + - + 0 | 0 + - + 0 + - + - + 0 | 0 + - + 0 + - + - + 0 + - + 0 + - + 0 + 0 + - - - + 0 | 0 + - + 0 + - + 
| 0 | 0 0 0 | 0 | 0 0 0 0 0 | 0 0 0 | 0 0 0 | 0 0 0 | 0 | 0 0 0 | 0 0 0 | 0 0 0 0 0 0 0 | 0 | 0 0 0 0 0 | 0 | 0 0 0 | 0 0 0 | 
| 0 + 0 + 0 + 0 + - - - - - + - + 0 + - + 0 | 0 + - + 0 + - - - + 0 + 0 + - - - + - + 0 + 0 + - - - + 0 + - + - + 0 + - + 0 | 
| 0 0 0 | 0 0 0 | 0 0 0 0 0 | 0 0 0 | 0 | 0 | 0 | 0 0 0 | 0 0 0 0 0 | 0 0 0 0 0 | 0 0 0 0 0 | 0 0 0 0 0 0 0 | 0 0 0 | 0 | 0 | 
+ - + - + - + 0 | 0 + - + 0 + 0 + 0 | 0 | 0 | 0 | 0 + - + 0 + - - - + - - - + 0 + - + - - - + - - - + - + 0 | 0 + - + 0 | 0 | 
| 0 | 0 0 0 0 0 | 0 | 0 0 0 0 0 | 0 | 0 | 0 | 0 | 0 0 0 0 0 | 0 0 0 0 0 0 0 | 0 0 0 | 0 0 0 | 0 0 0 | 0 0 0 | 0 0 0 | 0 | 0 | 
| 0 | 0 + - - - + 0 + - + - - - + 0 + 0 | 0 + 0 + - + - - - + 0 + - - - + 0 | 0 + 0 | 0 + 0 + 0 + 0 | 0 + - + 0 + 0 | 0 + 0 | 
| 0 | 0 0 0 0 0 | 0 0 0 | 0 0 0 0 0 0 0 | 0 0 0 0 0 | 0 0 0 0 0 | 0 0 0 | 0 | 0 | 0 | 0 | 0 0 0 | 0 | 0 | 0 | 0 | 0 | 0 0 0 | 
| 0 + - - - + 0 + - + 0 | 0 + - - - - - + - + - + 0 | 0 + - - - + - + 0 + 0 + - + 0 | 0 + - + - + 0 | 0 | 0 + 0 | 0 + - + 0 | 
| 0 | 0 0 0 | 0 0 0 | 0 | 0 | 0 0 0 0 0 0 0 | 0 0 0 | 0 | 0 0 0 0 0 | 0 0 0 0 0 0 0 | 0 | 0 | 0 0 0 | 0 | 0 0 0 | 0 0 0 | 0 | 
| 0 + 0 + 0 + - + 0 | 0 + - + 0 + - - - + 0 + - - - + 0 | 0 + - + 0 + - - - - - - - + 0 | 0 | 0 + - + 0 + - - - + - + 0 | 0 | 
| 0 0 0 | 0 0 0 | 0 | 0 0 0 | 0 0 0 0 0 | 0 0 0 0 0 | 0 | 0 0 0 | 0 0 0 0 0 0 0 0 0 | 0 | 0 | 0 | 0 0 0 0 0 0 0 0 0 0 0 | 0 | 
| 0 + - + - + 0 | 0 + - + 0 + - - - + 0 + - - - + 0 | 0 + - + 0 + - - - + - - - + 0 | 0 + 0 | 0 | 0 + - + - - - - - - - + 0 | 
| 0 | 0 0 0 | 0 | 0 0 0 0 0 0 0 0 0 | 0 | 0 0 0 | 0 | 0 | 0 0 0 | 0 0 0 | 0 0 0 0 0 | 0 0 0 | 0 | 0 0 0 | 0 0 0 0 0 0 0 | 0 | 
| 0 + - + 0 | 0 + 0 + - - - + - + 0 | 0 + - + 0 | 0 | 0 | 0 + - + 0 + 0 | 0 + - - - + - + 0 | 0 + - - - + 0 + - - - + 0 | 0 | 
| 0 | 0 0 0 | 0 0 0 | 0 0 0 | 0 0 0 | 0 | 0 0 0 | 0 | 0 | 0 | 0 0 0 | 0 | 0 0 0 0 0 0 0 | 0 | 0 0 0 0 0 | 0 | 0 0 0 0 0 | 0 | 
| 0 + 0 + 0 + - + - + 0 + 0 | 0 + - + 0 | 0 + 0 | 0 + 0 | 0 | 0 + - + 0 + - - - - - + 0 + 0 + - + - + 0 | 0 | 0 + - - - + 0 | 
| 0 0 0 | 0 0 0 | 0 0 0 | 0 | 0 | 0 | 0 | 0 | 0 | 0 0 0 | 0 | 0 | 0 | 0 | 0 0 0 0 0 | 0 0 0 0 0 | 0 0 0 | 0 | 0 | 0 0 0 0 0 | 
+ - + 0 + - - - + 0 + - + 0 | 0 | 0 | 0 | 0 + - + - + 0 | 0 | 0 | 0 | 0 + - - - + 0 + - - - + - + 0 + 0 | 0 | 0 + - + 0 + - + 
| 0 | 0 | 0 0 0 0 0 | 0 | 0 | 0 | 0 | 0 | 0 0 0 0 0 0 0 | 0 | 0 | 0 | 0 | 0 0 0 0 0 | 0 0 0 | 0 0 0 | 0 | 0 | 0 0 0 | 0 0 0 | 
| 0 + - + 0 + - - - + 0 | 0 | 0 + 0 | 0 + - - - - - + - + 0 | 0 | 0 + 0 + 0 + - + 0 + - + 0 | 0 + - + - + 0 + - + 0 + - + 0 | 
| 0 0 0 0 0 | 0 0 0 0 0 | 0 | 0 0 0 | 0 0 0 0 0 0 0 | 0 0 0 | 0 | 0 0 0 0 0 | 0 0 0 0 0 | 0 | 0 0 0 0 0 | 0 | 0 0 0 | 0 0 0 | 
+ - - - - - + 0 + 0 + 0 | 0 + - + 0 + - - - - - + 0 | 0 + - + 0 + - + 0 + - + - - - + 0 + 0 + - - - + 0 | 0 | 0 + - + - - - + 
| 0 0 0 0 0 | 0 | 0 | 0 | 0 0 0 | 0 | 0 0 0 0 0 0 0 | 0 | 0 0 0 0 0 | 0 | 0 0 0 0 0 | 0 0 0 | 0 0 0 | 0 | 0 | 0 0 0 0 0 0 0 | 
| 0 + - + 0 | 0 | 0 + - + - + 0 | 0 | 0 + - - - - - + 0 + - - - + 0 + - + 0 + - + 0 + - + 0 | 0 + 0 | 0 + 0 + - - - - - + 0 | 
| 0 | 0 0 0 | 0 | 0 0 0 0 0 0 0 | 0 | 0 0 0 0 0 0 0 0 0 | 0 0 0 | 0 | 0 0 0 0 0 | 0 | 0 0 0 | 0 | 0 | 0 0 0 0 0 0 0 0 0 | 0 | 
| 0 | 0 + - + 0 + - - - - - - - + 0 + - - - - - - - - - + 0 + 0 | 0 | 0 + - - - + 0 | 0 + - + 0 | 0 + - + - - - - - + - + 0 | 
| 0 | 0 0 0 0 0 | 0 0 0 0 0 0 0 0 0 | 0 0 0 0 0 0 0 0 0 0 0 | 0 | 0 | 0 | 0 0 0 0 0 | 0 0 0 0 0 | 0 0 0 | 0 0 0 0 0 | 0 0 0 | 
| 0 + - + - - - + - - - + 0 + - - - + 0 + - - - + - - - + 0 | 0 | 0 + 0 | 0 + - + 0 + - - - + - + - + 0 | 0 + - + 0 + 0 + 0 | 
| 0 | 0 | 0 0 0 0 0 0 0 | 0 | 0 0 0 0 0 | 0 0 0 | 0 0 0 0 0 | 0 | 0 0 0 | 0 | 0 0 0 | 0 0 0 | 0 | 0 0 0 | 0 | 0 | 0 0 0 | 0 | 
| 0 | 0 + 0 + 0 + - + 0 | 0 + - - - + 0 | 0 + 0 | 0 + - + - + 0 + - - - + 0 | 0 + - + 0 + 0 | 0 + 0 + - + 0 | 0 + - - - + 0 | 
| 0 | 0 0 0 | 0 | 0 0 0 | 0 0 0 0 0 | 0 | 0 | 0 | 0 0 0 | 0 0 0 0 0 0 0 0 0 | 0 | 0 0 0 | 0 | 0 0 0 | 0 0 0 | 0 0 0 0 0 | 0 | 
| 0 + - - - + 0 | 0 + - + - + - + 0 | 0 + 0 | 0 + - + 0 + - + - - - - - - - + 0 | 0 + - + 0 + - + 0 | 0 + - + 0 + - + 0 + 0 | 
| 0 0 0 0 0 0 0 | 0 0 0 0 0 | 0 0 0 | 0 0 0 | 0 0 0 | 0 0 0 | 0 0 0 0 0 0 0 | 0 | 0 | 0 0 0 0 0 | 0 | 0 0 0 | 0 0 0 | 0 0 0 | 
+ - - - - - - - + - - - + 0 | 0 + - + - - - + - + - + - + 0 + - + - + 0 + - + 0 | 0 + - - - + 0 + - + - + 0 + - - - + - - - + 
| 0 0 0 0 0 0 0 0 0 0 0 | 0 | 0 | 0 0 0 0 0 0 0 | 0 0 0 | 0 0 0 | 0 0 0 | 0 0 0 | 0 | 0 0 0 | 0 | 0 0 0 | 0 | 0 0 0 0 0 0 0 | 
| 0 + 0 + - + - - - - - + 0 | 0 + 0 + - - - + 0 + 0 + 0 | 0 + 0 | 0 + - + 0 + - + 0 | 0 + 0 | 0 + 0 + 0 | 0 + 0 + - + - + 0 | 
| 0 | 0 0 0 | 0 0 0 0 0 0 0 | 0 0 0 | 0 0 0 0 0 0 0 | 0 | 0 | 0 | 0 0 0 0 0 | 0 0 0 | 0 | 0 | 0 0 0 | 0 | 0 0 0 0 0 | 0 0 0 | 
| 0 + - + 0 | 0 + - - - - - + - - - + 0 + - - - + - + 0 + - + 0 | 0 + - - - + 0 + - + 0 | 0 + - + - + 0 + - - - - - + 0 + 0 | 
| 0 | 0 0 0 | 0 | 0 0 0 0 0 0 0 0 0 0 0 | 0 0 0 | 0 | 0 | 0 0 0 | 0 0 0 0 0 | 0 | 0 0 0 | 0 0 0 | 0 0 0 | 0 0 0 0 0 | 0 | 0 | 
| 0 | 0 + 0 | 0 + - - - + 0 + - - - + - + 0 + 0 | 0 + 0 + 0 + - + - - - + 0 | 0 + 0 + - + - + 0 | 0 + - + 0 + - + 0 | 0 | 0 | 
| 0 | 0 | 0 | 0 | 0 0 0 | 0 0 0 0 0 | 0 0 0 | 0 | 0 0 0 0 0 | 0 0 0 0 0 0 0 | 0 0 0 0 0 0 0 | 0 | 0 0 0 0 0 | 0 0 0 | 0 | 0 | 
| 0 | 0 + - + 0 | 0 + 0 + - - - + 0 | 0 + - + 0 | 0 + - - - + - - - + - - - + - - - + - - - + 0 + - - - - - + 0 + - + 0 | 0 | 
| 0 | 0 | 0 0 0 | 0 | 0 | 0 0 0 0 0 | 0 | 0 0 0 | 0 | 0 0 0 | 0 0 0 | 0 0 0 | 0 0 0 | 0 0 0 0 0 | 0 0 0 0 0 | 0 0 0 | 0 | 0 | 
+ - + 0 | 0 + - + 0 | 0 + - - - + - + 0 | 0 + - + 0 | 0 + 0 + 0 + 0 | 0 + 0 + 0 + 0 + 0 + - - - + 0 + 0 + - + - + 0 | 0 | 0 | 
| 0 0 0 | 0 | 0 0 0 | 0 | 0 0 0 | 0 0 0 | 0 | 0 0 0 | 0 | 0 0 0 | 0 | 0 | 0 0 0 | 0 0 0 | 0 0 0 0 0 | 0 | 0 0 0 0 0 | 0 | 0 | 
| 0 + - + 0 + - + 0 | 0 | 0 + 0 | 0 + - + 0 + - - - + 0 + - + - + 0 | 0 + - + - + - - - + 0 + 0 + - + - + 0 + - - - + 0 | 0 | 
| 0 0 0 | 0 0 0 0 0 | 0 | 0 | 0 | 0 0 0 | 0 | 0 0 0 | 0 0 0 | 0 | 0 | 0 | 0 | 0 0 0 0 0 | 0 | 0 | 0 0 0 0 0 | 0 0 0 0 0 | 0 | 
| 0 + 0 + - - - - - + 0 + 0 | 0 + - + 0 | 0 + 0 + 0 + - + 0 | 0 + 0 + 0 | 0 + 0 + - + 0 + 0 | 0 + 0 + - - - + - + 0 + - + 0 | 
| 0 | 0 0 0 0 0 0 0 0 0 0 0 | 0 0 0 0 0 | 0 0 0 | 0 0 0 0 0 | 0 0 0 0 0 | 0 0 0 0 0 | 0 0 0 | 0 0 0 0 0 0 0 0 0 0 0 | 0 0 0 | 
+ - + - - - - - - - - - - - + - - - - - + - - - + - - - - - + 0 + - - - + - - - - - + - - - + - - - - - - - - - - - + - - - + 
